@ gramaparede.tga
@ gramachao.tga
@ gramaparede.tga

#.#...J..........B.....#.#
#########.###.####....####
......F.#..V..L####..###..
.L...####....######.......
####..................####
####.#############...B####
.......########....####L..
......V...................
##############.....#######
####..J##########C........
####...#####..........V...
#####.#....B........F.####
............########......
....##......#.L....#......
.L..###....L#..##..#.....#
....##.V....#.....J#......
...#####....###.####.....#
..............V..........C.
