@ madeiraparede.tga
@ madeirachao.tga
@ madeirateto.tga 

################################
#...##........L.........L......#
#..#........###......##.....#..#
#..##...L.##...#...V...#....#..#
#..#...###....J#......#..#....L#
#.C###....V..###.....L###..C...#
#..#.#......#..#B.#####.....#..#
#..###...###.....#....##.#..#..#
#...V#..........#........#...#.#
#..###.....#....#...V..#..#...##
#..B.....L.#...C........#..#LF.#
#..#.......#..######....#..#####
#...#..L...#..#....#....#......#
#....#....#......V#.....#.....J#
################################
