@ abanparede.tga
@ abanchao.tga
@ abanteto.tga

N

########################################
#.................J....................#
#...V.......#......#####.#####.....V...#
#...........#..B...#...#.#...#.........#
#.........V.#####..#...#.#.###.........#
#...........#......#...#.#.............#
#....B......#####..#####.#####B......B.#
#....................F.................#
###############.##########.#############
###############.##########.#############
#############.....#####......###########
#............B........V..............C.#
#.F#####################################
#........B........V....................#
###...........B..................B.....#
#####################################..#
#.V.....................B..........B...#
################...#####################
...#############...###################..
.......#######.......########...........
.......#........L....L......#...........
.......#.....L....J.....L...#...........
