J....L...J
.######.#.
.#..L...#.
.#.####.#.
.#..CC#.#.
.#.#CC..#.
.#.####.#.
.#...L..#.
.#.######.
J....L...J
