@ geloparede.tga
@ madeirachao.tga
% pano3.tga

V.............V
.#...........#.
L#BB#FF#BB#BB#L
#.#....L.......
C.#......##....
.........C.....
....LL##....LL.
..........C....
..#.......##...
C.#....L.......
#..............
L#BB#FF#BB#BB#L
.#...........#.
V.............V
