@ gramaparede.tga
@ chao3.tga
% pano7.tga

C............C.....
.......B...#####B..
B.####...B.........
.....L......L......
....#####......####
..L................
........#####..L...
####......V........
C..................
#######......######
...................
...................
.......######......
...................
......#............
......#............
......#..J..#......
......#.....#......
......#.....#......
J..........F#.....J
