J..#..C.....C..#..J
.....#########.....
####.....#.....####
...#..L..#..L..#...
.........#.........
...#.....#.....#...
####..L.....L..####
...#.....#.....#...
.........#.........
...#..L..#..L..#...
####.....#.....####
.....#########.....
J..#..C.....C..#..J
