J.......V........J
..................
..#####....#####..
..#####....#####..
..#####....#####..
...L..............
................B.
........C.........
.F................
.............L....
..#####....#####..
..#####....#####..
..#####....#####..
..................
J.......V........J
