J........J
.#.#..###.
........#.
.#.L..L.#.
..........
..........
.#.L..L.#.
.#........
.###..#.#.
J........J
