J........J
......V...
..V.......
......V...
....L.....
..........
..........
......V...
..V.......
J........J
