J..#...#.J
.#...#...#
...#...#..
.#...#...#
...#.L.#..
.#...#...#
...#...#..
.#...#...#
...#...#..
J#...#..J#
