@ parede4.tga
@ chao4.tga
% pano2.tga

J...........J
.#####.......
.#L.L#.......
.##.##...###.
.........#F#.
.....J...B.#.
.........#C#.
...#####.###.
...#L.L#.....
...##.##.....
##...........
L#......##.##
.....J..#L.LL
