J........J
.######.#.
.#..J...#.
.#.####.#.
.#..L.#.#.
.#.#....#C
.#.####.#.
C#..L...#.
.#.######.
.#.####.#.
.#......#.
.#.####.#.
.#..L.#.#.
C#.#....#C
.#.####.#.
.#...J..#.
J#.####.#J
.######.#.
.#......#.
.#.####.#.
.#....#.#.
.#.#.L..#.
C#.#....#C
.#.####.#.
.#..J...#.
.#.######.
.#.####.#.
.#...L..#.
.#.######.
J........J
