@ parede.tga
@ chao.tga
% fundoCeu.tga

J........J
.######.#.
.#..J...#.
.#.####.#B
B#..L.#.#.
.#.#....#C
.#.####.#.
C#..L...#.
.#.######.
.#.####.#.
F#......#B
.#.####.#.
.#..L.#.#.
C#.#....#C
.#.####.#.
.#...J..#.
J#.####.#J
.######.#.
.#......#B
B#.####.#.
.#....#.#F
.#.#.L..#.
C#.#....#C
.#.####.#.
.#..J...#.
.#.######.
B#.####.#B
.#...L..#.
.#.######.
J....V...J
