@ parede2.tga
@ chao2.tga
@ cave.tga

N

J..L#C.##..##.J
.####...#.V.#.#
....###.#.#...#
###..L...F###.C
.C#B###B###.#B#
B##.....F...#.L
..V.######..#.#
B#....C.....V..
.##B####B#####B
L.#.V...F.L..#.
#.#.###.#.##...
#.#...#V#.#####
.L#.#.#.#.....C
.##.#.#.####.##
J...#.C.......J
