@ cave.tga
@ cave.tga

##..J...L....J..##
##......B.......##
###............###
####..B.C..B..####
#####...B....#####
######......######
#######.VV.#######
########FV########
#######.VV.#######
######..B...######
#####........#####
####....C.....####
###..B......B..###
##......B.......##
##..J...L....J..##
