J........J
......V...
..........
..........
....L.....
..........
..........
..........
..........
J........J
