@ cave.tga
@ window.tga
% pano4.tga

FFFFLFFFFJ
FLFFFFFFFF
FFFFFFFFFF
FFFFFFFLFF
FFFFFFFFFF
FLFFFFFFFF
FFFFFFFFFF
FFFFFFFFFF
FFFFLFFFLF
JFFFFFFFFF
