@ parede4.tga
@ chao4.tga

.L.#..#.L.
.#.##.#.#.
....J.....
####.#####
...#..J.#.
L#.J..#..L
#####.####
....J.....
.#.#.##.#.
.L.#..#.L.
